"filename", "language", "JavaScript", "JSON", "Markdown", "HTML", "CSS", "comment", "blank", "total"
"c:\Users\86135\Desktop\Todolist\前端\my-app\README.md", "Markdown", 0, 0, 38, 0, 0, 0, 33, 71
"c:\Users\86135\Desktop\Todolist\前端\my-app\package-lock.json", "JSON", 0, 19476, 0, 0, 0, 0, 1, 19477
"c:\Users\86135\Desktop\Todolist\前端\my-app\package.json", "JSON", 0, 44, 0, 0, 0, 0, 1, 45
"c:\Users\86135\Desktop\Todolist\前端\my-app\public\index.html", "HTML", 0, 0, 0, 20, 0, 23, 1, 44
"c:\Users\86135\Desktop\Todolist\前端\my-app\public\manifest.json", "JSON", 0, 25, 0, 0, 0, 0, 1, 26
"c:\Users\86135\Desktop\Todolist\前端\my-app\src\App.css", "CSS", 0, 0, 0, 0, 101, 6, 4, 111
"c:\Users\86135\Desktop\Todolist\前端\my-app\src\App.js", "JavaScript", 88, 0, 0, 0, 0, 0, 16, 104
"c:\Users\86135\Desktop\Todolist\前端\my-app\src\iconfont\demo.css", "CSS", 0, 0, 0, 0, 435, 19, 86, 540
"c:\Users\86135\Desktop\Todolist\前端\my-app\src\iconfont\demo_index.html", "HTML", 0, 0, 0, 191, 0, 2, 19, 212
"c:\Users\86135\Desktop\Todolist\前端\my-app\src\iconfont\iconfont.css", "CSS", 0, 0, 0, 0, 16, 0, 4, 20
"c:\Users\86135\Desktop\Todolist\前端\my-app\src\iconfont\iconfont.js", "JavaScript", 1, 0, 0, 0, 0, 0, 0, 1
"c:\Users\86135\Desktop\Todolist\前端\my-app\src\iconfont\iconfont.json", "JSON", 0, 16, 0, 0, 0, 0, 1, 17
"c:\Users\86135\Desktop\Todolist\前端\my-app\src\index.js", "JavaScript", 11, 0, 0, 0, 0, 1, 4, 16
"c:\Users\86135\Desktop\Todolist\前端\my-app\src\page\AfterLogIn.js", "JavaScript", 137, 0, 0, 0, 0, 5, 19, 161
"c:\Users\86135\Desktop\Todolist\前端\my-app\src\page\App.js", "JavaScript", 117, 0, 0, 0, 0, 4, 20, 141
"c:\Users\86135\Desktop\Todolist\前端\my-app\src\page\LogIn.css", "CSS", 0, 0, 0, 0, 12, 2, 0, 14
"c:\Users\86135\Desktop\Todolist\前端\my-app\src\page\LogIn.js", "JavaScript", 42, 0, 0, 0, 0, 0, 4, 46
"c:\Users\86135\Desktop\Todolist\前端\my-app\src\page\Register.js", "JavaScript", 39, 0, 0, 0, 0, 0, 5, 44
"c:\Users\86135\Desktop\Todolist\前端\my-app\src\page\register.css", "CSS", 0, 0, 0, 0, 12, 2, 0, 14
"c:\Users\86135\Desktop\Todolist\前端\my-app\src\router.js", "JavaScript", 24, 0, 0, 0, 0, 0, 2, 26
"Total", "-", 459, 19561, 38, 211, 576, 64, 221, 21130